width=20
height=10
tileSize=50
6,0,0,0,0,0,0,0,0,0,0,0,0,0,0,0,0,0,0,6,
6,0,0,0,0,0,0,0,0,0,0,0,0,0,0,0,0,0,0,6,
6,0,0,0,0,0,0,0,0,0,0,0,0,0,0,0,0,0,0,6,
6,0,0,0,0,0,0,0,0,3,0,0,0,0,0,0,0,0,0,6,
6,0,0,0,0,0,0,0,4,1,5,0,0,0,0,0,0,0,0,6,
6,7,0,0,0,0,0,0,0,2,0,0,0,0,0,0,0,0,0,6,
6,6,7,0,0,0,0,0,0,0,0,0,0,0,0,0,0,9,0,6,
6,6,6,7,7,7,7,7,7,1,0,8,0,0,1,7,7,7,7,6,
6,6,6,6,6,6,6,6,6,1,1,1,1,1,1,6,6,6,6,6,
6,6,6,6,6,6,6,6,6,6,6,6,6,6,6,6,6,6,6,6,
playerPos=1,4
